B,P,B,P,B
B,G,B,B,P
P,P,B,W,B
B,P,B,B,B
S,B,B,B,B
